100
9
5 8 8 8 8 8 8 8 8 8 8 5 5 5 5 5 5 5 5 5 5 5 5 5 5 5 5 5 5 5 5 5 5 5 5 5 5 5 8 8 8 8 8 5 5 5 5 5 5 5 5 5 5 5 5 5 5 5 5 5 5 5 5 5 5 5 5 5 5 5 5 5 5 5 5 8 8 8 8 8 5 5 5 5 5 5 5 5 5 5 5 5 5 5 5 5 5 5 5 5 
5 8 8 8 8 8 8 8 8 8 8 5 8 8 8 8 8 8 8 8 8 8 8 8 8 8 8 8 8 8 8 8 8 8 8 8 8 5 8 8 8 8 8 5 5 8 8 8 8 8 8 8 8 8 8 8 8 8 8 5 8 8 8 8 8 8 8 8 8 8 8 8 8 5 5 8 8 8 8 8 5 8 8 8 8 8 8 8 8 8 8 8 8 8 8 8 8 8 8 5 
5 8 8 8 8  8 8 8 8 8 8 5 4 8 8 8 8 8 8 8 8 8 8 8 8 8 8 8 8 8 8 8 8 8 8 8 3 5 8 8 8 8 8 5 5 4 8 8 8 8 8 8 8 8 8 8 8 8 8 5 8 8 8 8 8 8 8 8 8 8 8 8 3 5 5 8 8 8 8 8 5 8 8 8 8 8 8 8 8 8 8 8 8 8 8 8 8 8 8 5 
5 8 8 8 8 8 8 8 8 8 8 5 5 4 8 8 8 8 8 8 8 8 8 8 8 8 8 8 8 8 8 8 8 8 8 3 5 5 8 8 8 8 8 5 8 7 8 8 8 8 8 8 8 8 8 8 8 8 8 5 8 8 8 8 8 8 8 8 8 8 8 8 6 8 5 8 8 8 8 8 5 8 8 8 8 8 8 8 8 8 8 8 8 8 8 8 8 8 8 5 
5 8 8 8 5 5 8 8 8 8 8 5 5 5 4 8 8 8 8 8 8 8 8 8 8 8 8 8 8 8 8 8 8 8 3 5 5 5 8 8 8 8 8 5 8 5 4 8 8 8 8 8 8 8 8 8 8 8 8 5 8 8 8 8 8 8 8 8 8 8 8 3 5 8 5 8 8 8 8 8 5 8 8 8 8 8 8 8 8 8 8 8 8 8 8 8 8 8 8 5 
5 5 5 5 5 5 5 5 7 8 8 5 5 5 5 4 8 8 8 8 8 8 8 8 8 8 8 8 8 8 8 8 8 3 5 5 5 5 5 13 13 13 5 5 8 5 7 8 8 8 8 8 8 8 8 8 8 3 1 5 2 4 8 8 8 8 8 8 8 8 8 6 5 8 5 5 13 13 13 5 5 8 8 8 8 8 8 8 8 8 8 8 8 8 8 8 8 8 8 5 
5 5 5 5 5 5 5 5 7 8 8 5 5 5 5 5 4 8 8 8 8 8 8 8 8 8 8 8 8 8 8 8 3 5 5 5 5 5 5 13 13 5 5 5 8 5 5 4 8 8 8 8 8 8 8 8 8 8 8 8 8 8 8 8 8 8 8 8 8 8 3 5 5 8 5 5 13 13 5 5 5 8 8 8 8 8 8 8 8 8 8 8 8 8 8 8 8 8 8 5 
5 8 8 8 8 8 8 8 8 8 8 8 8 8 8 8 8 8 8 8 8 8 8 8 8 8 8 8 8 8 8 8 8 8 8 8 8 8 8 8 8 8 8 8 8 8 8 8 8 8 8 8 8 8 8 8 8 8 8 8 8 8 8 8 8 8 8 8 8 8 8 8 8 8 8 8 8 8 8 8 8 8 8 8 8 8 8 8 8 8 8 8 8 8 8 8 8 8 8 5 
5 1 2 1 2 1 2 1 2 1 2 1 1 2 1 2 1 2 1 2 1 2 1 2 1 2 1 2 1 2 1 2 1 2 1 2 1 2 1 2 1 2 1 2 1 2 1 2 1 2 1 2 1 2 1 2 1 2 1 2 1 2 1 2 1 2 1 2 1 2 1 2 1 2 1 2 1 5 5 5 5 5 5 5 5 5 5 5 5 5 5 5 5 5 5 5 5 5 5 5 