14
9
4 8 8 8 8 8 8 8 8 8 8 8 8 8
7 8 8 8 8 8 8 8 8 8 8 8 8 8
7 8 8 8 8 8 8 8 8 8 8 8 8 8
7 8 8 8 8 8 8 8 8 8 8 8 8 8
7 8 8 8 8 8 8 8 8 8 8 8 8 8
7 8 8 8 8 8 8 8 8 8 8 8 8 3
7 8 8 8 8 8 8 8 8 8 8 3 2 5
7 8 8 8 3 1 4 8 8 8 3 5 5 5
5 1 2 1 5 5 5 1 2 1 5 5 5 5
