122
9
7 8 8 8 8 8 8 8 8 8 8 8 8 8 8 8 8 8 8 8 8 8 8 8 8 8 8 8 8 8 8 8 8 8 8 8 8 8 8 8 8 8 8 8 8 8 8 8 8 8 8 8 8 8 8 8 8 8 8 8 8 8 8 8 8 8 8 8 8 8 8 8 8 8 8 8 8 8 8 8 8 8 8 8 8 8 8 8 8 8 8 8 8 8 8 8 8 8 8 7 
7 8 8 8 8 8 8 8 8 8 8 8 8 8 8 8 8 8 8 8 8 8 8 8 8 8 8 8 8 8 8 8 8 8 8 8 8 8 8 8 8 8 8 8 8 8 8 8 8 8 8 8 8 8 8 8 8 8 8 8 8 8 8 8 8 8 8 8 8 8 8 8 8 8 8 8 8 8 8 8 8 8 8 8 8 8 8 8 8 8 8 8 8 8 8 8 8 8 8 7 
7 8 8 8 8 8 8 8 8 8 8 8 8 8 8 8 8 8 8 8 8 8 8 8 8 8 8 8 8 8 8 8 8 8 8 8 8 8 8 8 8 8 8 8 8 8 8 8 8 8 8 8 8 8 8 8 8 8 8 8 8 8 8 8 8 8 3 1 1 4 8 8 8 8 8 8 8 8 8 8 8 8 8 8 8 8 8 8 8 8 8 8 8 8 8 8 8 8 8 7 
7 8 8 8 8 8 8 8 8 8 8 8 8 8 8 8 8 8 8 8 8 8 8 8 8 8 8 8 8 8 8 8 8 8 8 8 8 8 8 8 8 8 8 8 8 8 8 8 8 8 8 8 8 8 8 8 8 8 8 8 8 8 8 8 8 8 5 7 7 6 8 8 8 8 8 8 8 8 8 8 3 1 4 8 8 8 8 8 8 8 8 8 8 8 8 8 8 8 8 7 
7 8 8 8 8 8 8 8 8 8 8 8 8 8 8 8 8 8 8 8 8 8 8 8 8 8 8 8 8 8 8 8 8 8 8 8 8 8 8 8 8 8 8 8 8 8 8 8 8 8 8 8 8 8 8 8 3 1 4 8 8 8 8 8 8 8 5 7 7 7 1 2 1 2 4 8 8 8 8 8 8 8 8 8 8 8 8 8 8 8 8 8 8 8 8 8 8 8 8 7 
7 8 8 8 8 8 8 8 8 8 8 8 8 8 8 8 8 3 8 8 8 8 8 8 8 8 8 8 8 8 8 8 8 8 8 8 8 8 8 8 8 8 8 8 8 8 3 2 4 8 8 8 8 8 8 3 7 7 6 8 8 8 8 8 8 8 5 7 7 7 7 7 7 7 7 4 8 8 8 8 8 8 8 8 8 8 8 8 8 8 8 8 8 8 8 8 8 8 8 7 
7 8 8 8 8 8 8 8 8 8 8 8 8 3 1 4 8 5 4 8 8 8 8 8 8 8 8 8 3 4 8 8 8 8 8 8 8 8 3 4 8 8 8 8 8 8 8 8 8 8 8 8 8 8 3 7 7 7 6 8 8 8 8 8 8 8 5 7 7 7 7 7 7 7 7 7 4 8 8 8 8 8 8 8 8 8 8 8 8 8 8 8 8 8 8 8 8 8 8 7 
7 8 8 8 8 8 8 8 8 8 8 8 8 8 8 8 8 5 7 4 8 8 8 8 8 8 8 3 7 6 8 8 8 8 8 8 8 3 7 7 4 8 8 8 8 8 8 8 8 8 8 8 8 3 7 7 7 7 6 8 8 8 8 8 8 8 5 7 7 7 7 7 7 7 7 7 6 8 8 8 8 8 8 8 8 8 8 8 8 8 8 8 8 8 8 8 8 8 8 7 
7 1 2 2 1 1 1 1 2 1 2 1 2 1 2 1 1 7 7 7 1 2 1 2 2 2 2 7 7 7 2 1 1 2 1 2 1 7 7 7 7 2 1 2 1 2 1 2 1 2 1 2 1 7 7 7 7 7 7 2 1 2 1 2 2 1 7 7 7 7 7 7 7 7 7 7 7 1 2 1 2 1 2 1 2 1 2 1 2 1 2 1 2 1 2 1 2 1 2 7 


