100
9
5 8 8 8 8 8 8 8 8 8 8 8 8 8 8 8 8 8 8 8 8 8 8 8 8 8 8 8 8 8 8 8 8 8 8 8 8 8 8 8 8 8 8 8 8 8 8 8 8 8 8 8 8 8 8 8 8 8 8 8 8 8 8 8 8 8 8 8 8 8 8 8 8 8 8 8 8 8 8 8 8 8 0 0 0 0 0 0 0 0 0 0 0 0 0 0 0 0 0 5 
5 8 8 8 8 8 8 8 8 8 8 8 8 8 8 8 8 8 8 8 8 8 8 8 8 8 8 8 8 8 8 8 8 8 8 8 8 8 8 8 8 8 8 8 8 8 8 8 8 8 8 8 8 8 8 8 8 8 8 8 8 8 8 8 8 8 8 8 8 8 8 8 8 8 8 8 8 8 8 8 8 8 0 8 8 8 8 8 8 8 8 8 8 8 8 8 8 0 0 5 
5 8 8 8 8 8 8 8 8 8 8 8 8 8 8 8 8 8 8 8 8 8 8 8 8 8 8 8 3 1 2 1 2 1 2 4 8 8 8 8 8 8 8 8 8 8 8 8 8 8 8 8 8 8 8 8 8 8 8 8 8 8 8 8 8 8 8 8 8 8 8 8 8 8 8 8 8 8 8 8 8 8 3 4 8 8 8 8 8 8 8 8 8 8 8 8 8 8 8 5 
5 8 8 8 8 8 8 8 8 8 8 8 8 8 8 8 8 8 8 8 8 8 8 8 8 8 8 8 8 8 8 8 8 8 8 8 8 8 3 4 8 4 8 8 8 8 8 8 8 8 8 8 8 3 4 8 8 8 8 8 8 3 4 8 8 8 8 8 8 8 8 8 8 8 8 8 8 8 8 8 8 3 5 8 8 0 8 8 8 0 0 0 8 8 8 8 8 8 5 5 
5 8 8 8 8 8 8 8 8 3 4 8 8 8 8 8 8 8 8 8 8 8 8 8 8 8 8 8 8 8 8 8 8 8 8 8 8 8 8 8 8 8 8 8 8 8 8 8 8 8 8 8 3 5 7 8 8 8 8 8 8 6 5 4 8 8 8 8 8 8 8 8 8 8 8 8 8 8 8 8 3 5 5 7 8 0 0 0 0 0 3 4 0 8 8 8 8 8 8 5 
5 8 8 8 8 8 8 8 8 8 8 8 8 8 3 4 8 8 8 8 3 4 8 8 8 8 8 8 8 8 8 8 8 8 8 8 8 8 8 8 3 4 8 8 8 8 8 8 8 8 8 3 5 5 7 8 8 8 8 8 8 6 5 5 4 8 8 8 8 8 8 8 8 8 8 8 8 8 8 3 5 5 5 8 8 0 0 0 0 0 0 0 0 8 3 4 8 8 5 5 
5 8 8 8 8 8 8 8 8 8 3 1 4 8 8 8 8 8 8 3 5 5 4 8 8 8 8 8 8 8 8 8 8 8 8 8 8 8 8 3 5 7 8 8 8 8 8 8 8 8 3 5 5 5 7 8 8 8 8 8 8 6 5 5 5 4 8 8 8 8 8 8 8 8 8 8 8 8 3 5 5 5 5 5 0 0 0 0 0 0 0 0 3 4 8 8 8 8 8 5 
5 8 8 8 8 8 8 8 8 8 8 8 8 8 8 8 8 8 3 5 5 5 5 4 8 8 8 8 8 8 8 8 8 8 8 8 8 8 3 5 5 7 8 8 8 8 8 8 8 3 5 5 5 5 7 8 8 3 4 8 8 6 5 5 5 5 4 8 8 8 8 8 8 8 8 8 8 3 5 5 5 5 5 5 8 0 8 0 0 8 3 4 8 8 0 8 8 8 5 5 
5 1 2 1 2 1 2 1 2 1 2 1 1 2 1 1 2 1 5 5 5 5 5 5 2 1 2 1 2 1 2 1 1 1 2 2 1 2 5 5 5 5 2 2 1 2 1 2 1 5 5 5 5 5 7 8 8 8 8 8 8 6 5 5 5 5 5 2 1 2 1 2 1 2 1 2 1 5 5 5 5 5 5 5 1 2 1 2 1 2 5 5 1 2 1 2 1 2 5 5 


