100
9
5 8 8 8 8 8 8 8 8 8 8 8 8 8 8 8 8 8 8 8 8 8 8 8 8 8 8 8 8 8 8 8 8 8 8 8 8 8 8 8 8 8 8 8 8 8 8 8 8 8 8 8 8 8 8 8 8 8 8 8 8 8 8 8 8 8 8 8 8 8 8 8 8 8 8 8 8 8 8 8 8 8 8 8 8 8 8 8 8 8 8 8 8 8 8 8 8 8 8 5 
5 8 8 8 8 8 8 8 8 8 8 8 8 8 8 8 8 8 8 8 8 8 8 8 8 8 8 8 8 8 8 8 8 8 8 8 8 8 8 8 8 8 8 8 8 8 8 8 8 8 8 8 8 8 8 8 8 8 8 8 8 8 8 8 8 8 8 8 8 8 8 8 8 8 8 8 8 8 8 8 8 8 8 8 8 8 8 8 8 8 8 8 8 8 8 8 8 8 8 5 
5 8 8 8 8 8 8 8 8 8 8 8 8 8 8 8 8 8 8 8 8 8 8 8 8 8 8 8 8 8 8 8 8 8 8 8 8 8 8 8 8 8 8 8 8 8 8 8 8 8 8 8 8 8 8 8 8 8 8 8 8 8 8 8 8 8 3 1 1 4 8 8 8 8 8 8 8 8 8 8 8 8 8 8 8 8 8 8 8 8 8 8 8 8 8 8 8 8 8 5 
5 8 8 8 8 8 8 8 8 8 8 8 8 8 8 8 8 8 8 8 8 8 8 8 8 8 8 8 8 8 8 8 8 8 8 8 8 8 8 8 8 8 8 8 8 8 8 8 8 8 8 8 8 8 8 8 8 8 8 8 8 8 8 8 8 8 6 5 5 6 8 8 8 8 8 8 8 8 8 8 3 1 4 8 8 8 8 8 8 8 8 8 8 8 8 8 8 8 8 5 
5 8 8 8 8 8 8 8 8 8 8 8 8 8 8 8 8 8 8 8 8 8 8 8 8 8 8 8 8 8 8 8 8 8 8 8 8 8 8 8 8 8 8 8 8 8 8 8 8 8 8 8 8 8 8 8 3 1 4 8 8 8 8 8 8 8 6 5 5 5 1 2 1 2 4 8 8 8 8 8 8 8 8 8 8 8 8 8 8 8 8 8 8 8 8 8 8 8 8 5 
5 8 8 8 8 8 8 8 8 8 8 8 8 8 8 8 8 3 8 8 8 8 8 8 8 8 8 8 8 8 8 8 8 8 8 8 8 8 8 8 8 8 8 8 8 8 3 2 4 8 8 8 8 8 8 3 5 5 7 8 8 8 8 8 8 8 6 5 5 5 5 5 5 5 5 4 8 8 8 8 8 8 8 8 8 8 8 8 8 8 8 8 8 8 8 8 8 8 8 5 
5 8 8 8 8 8 8 8 8 8 8 8 8 3 1 4 8 6 4 8 8 8 8 8 8 8 8 8 3 4 8 8 8 8 8 8 8 8 3 4 8 8 8 8 8 8 8 8 8 8 8 8 8 8 3 5 5 5 7 8 8 8 8 8 8 8 6 5 5 5 5 5 5 5 5 5 4 8 8 8 8 8 8 8 8 8 8 8 8 8 8 8 8 8 8 8 8 8 8 5 
5 8 8 8 8 8 8 8 8 8 8 8 8 8 8 8 8 6 5 4 8 8 8 8 8 8 8 3 5 6 8 8 8 8 8 8 8 3 5 5 4 8 8 8 8 8 8 8 8 8 8 8 8 3 5 5 5 5 7 8 8 8 8 8 8 8 6 5 5 5 5 5 5 5 5 5 6 8 8 8 8 8 8 8 8 8 8 8 8 8 8 8 8 8 8 8 8 8 8 5 
5 1 2 2 1 1 1 1 2 1 2 1 2 1 2 1 1 5 5 5 1 2 1 2 2 2 2 5 5 5 2 1 1 2 1 2 1 5 5 5 5 2 1 2 1 2 1 2 1 2 1 2 1 5 5 5 5 5 5 2 1 2 1 2 2 1 5 5 5 5 5 5 5 5 5 5 5 1 2 1 2 1 2 1 2 1 2 1 2 1 2 1 2 1 2 1 2 1 2 5



