14
9
3 0 0 0 0 0 0 0 0 0 0 0 0 0
6 0 0 0 0 0 0 0 0 0 0 0 0 0
6 0 0 0 0 0 0 0 0 0 0 0 0 0
6 0 0 0 0 0 0 0 0 0 0 0 0 0
6 0 0 0 0 0 0 0 0 0 0 0 0 0
6 0 0 0 0 0 0 0 0 0 0 0 0 2
6 0 0 0 0 0 0 0 0 0 0 2 1 4
6 0 0 0 2 1 3 0 0 0 2 4 4 4
4 1 1 1 4 4 4 1 1 1 4 4 4 4
